TTTTTTTTTTTTTTTTTTTTTTTTTTTTTTTTTTTTTTTTTTTTTTTTTTTTTTTTTTTR
L..........................................................R
L..........................................................R
L..........................................................R
L............................x.............................R
L..........................................................R
L..........................................................R
L..........................................................R
L..........................................................R
L..........................................................R
L..........................................................R
L..........................................................R
L..........................................................R
L..........................................................R
L..........................................................R
L..........................................................R
L..........................................................R
L..........................................................R
L..........................................................R
L..........................................................R
L..........................................................R
L..........................................................R
L..........................................................R
L..........................................................R
L..........................................................R
L..........................................................R
BBBBBBBBBBBBBBBBBBBBBB...............BBBBBBBBBBBBBBBBBBBBBBR
_____________________L...............R
_____________________L...............R
_____________________L...............R
_____________________L...............R
_____________________L...............R
_____________________L...............R
_____________________L...............R
_____________________BBBBBBBBBBBBBBBBB